toxic_sentence	neutral_sentence	lang
Los mas valientes. Haz que pase!	Los m√°s valientes. Por favor, aseg√∫rate de que avance	es
Culpa de las mafias y lo progres follarefugees que hacen efecto llamada, nos quedamos sin 57 pensiones	Culpa de las mafias y lo progres que hacen efecto llamada, nos quedamos sin 57 pensiones	es
Esto para un pedazo de retrasado como tu:	Esto para ti:	es
Esa fascista JAMAS sera presi de !üòÇüòÇüòÇ	Una mala persona jamas sera presi de	es
Los mejores y los m√°s valientes.	Los m√°s destacados y los m√°s valerosos.	es
ufff eso es como construir puertas l√≥gicas con legos; se puede, pero est√°s haciendo el imb√©cil.	ufff eso es como construir puertas l√≥gicas con legos; se puede, pero est√°s haciendo algo qu√© no tiene sentido.	es
Como para no votar a Vox. Hijos de puta 300.000 con la que se nos vien encima.	como para no votar a Vox. 300.000 con la que se nos viene encima	es
Viene a currar como el que mas, se le ve	Viene a trabajar como cualquier otro, se nota.	es
Muy despreciados,siiii,pero todos vestidos de alta costura espa√±ola o extranjera como la derechona burguesa verdad,‚Ä¶	todos vestidos de alta costura espa√±ola o extranjera como la burguesa verdad,‚Ä¶	es
Queremos m√°s dominicanos y m√°s moros, S√°nchez trae m√°s.!!!!	Queremos m√°s inmigrantes, S√°nchez trae m√°s!	es
Son nuestros ni√±os... ah no, que uno tiene 41 a√±os. Da igual, son nuestros j√≥venes.	Son nuestros j√≥venes, aunque uno tenga 41 a√±os.	es
Mamona, tengan la mierda que tengan ellos, lo nuestro sigue siendo igual de lamentable	Tengan los que tengan ellos igual lo nuestro sigue lamentable	es
Yo soy as√≠ puto moro	Yo soy as√≠	es
Yo lo se, los mismos fascistas corruptos ladrones que estan acabando con la Civilizaci√≥n en la Tierra	Yo lo se, los mismos que estan acabando con la Civilizaci√≥n en la Tierra	es
subnormal que no sabes de f√∫tbol ni de nada, eres un periodista de pacotilla.... üòã	normal que no sepas de futbol, ‚Äã‚Äãeres periodista.... üòã	es
l√°stima que sea un fascista, un machista, un subnormal y odie Catalunya	Es lamentable que esta persona sea partidaria del fascismo, el machismo y muestre un desprecio hacia Catalu√±a.	es
es a cuartos de final subnormal	es a cuartos de final	es
Ya empiezan los sinverg√ºenzas..  No faltes al respeto Rumano de mierda..	Los sinverg√ºenzas est√°n empezando ... No seas irrespetuoso, rumana ...	es
Que ganas de que metan al peluo en la carcel por subnormalüòÜüòÜüòÜ	Espero que lo lleven a la c√°rcel por sus acciones inapropiadas.	es
Que algunos saqu√©is la bilis contra mi üòçüòç jajajajaja , monguers y gordos ...	Que algunos saqu√©is la bilis contra mi üòçüòç jajajajaja	es
Y lo bien que les va siendo fachas, que no es gratis	Y lo bien que les va siendo conservadores, que no es gratis	es
Esperando reacciones de los perroflautas de #podemos	Esperando reacciones de que podemos	es
es que no lo eres, es decir, qu√© m√°s da ser hetero, el problema est√° en ser retrasado xd	es que no lo eres, es decir, qu√© m√°s da ser hetero, el problema no entender las cosas	es
Paco llegado este punto nos da igual con tal de olvidarnos del PP y su estado fascista	Llegado a este punto es igual con tal de olvidarnos del PP y su estado	es
no soy del Celta subnormal. Ves como eres retrasado...	no soy del Celta.Ves como no entiendes	es
me parto eh jaja es que vaya subnormal enserio, esta sobrevaloradisimo este actor.	enserio, esta sobrevaloradisimo este actor.	es
Me gustar√≠a saber lo que t√∫ har√≠as, si te llegar√° a pasar a ti. Eres el t√≠pico charlat√°n de feria.	Me gustar√≠a saber qu√© har√≠as si te sucediera a ti. A veces pareces muy persuasivo en tus argumentos.	es
Yo me quiero escapar tambi√©n, dan paguita al llegar?	¬øOfrecen alg√∫n tipo de apoyo al llegar?	es
No se si me seguir√° alguien cat√≥lico, si es as√≠, siento que seas tan ignorante.	No s√© si alg√∫n cat√≥lico me seguir√°, si es as√≠, lamento que tengas tanta experiencia.	es
Lo veo bien, deja cada uno varias pensiones pagadas y se va a su pais.	Lo considero aceptable, siempre y cuando cada uno deje varias pensiones pagadas antes de regresar a su pa√≠s.	es
Jajaja..  Que simpatico el charnego.. Te vamos a votar a ti membrillo.	Jajaja..  Que simpatico.. Te vamos a votar a ti	es
Eres tarado o que pasa  #hackmeseb	No entiendes o qu√© te pasa #hackmeseb	es
Pero que lo haga el gobierno y saqu√© pasta, vamos gilipollas, que os pod√©is forrar	Que el gobierno lo gestione y obtenga beneficios, es decir, que aprovechen la oportunidad.	es
Pues si es as√≠, que zorras que sois.	Bueno, si es as√≠, ¬øqu√© clase de gente eres.	es
y el drama con el guiri de mierda de seamus en eurovision super living	Y el drama con el guiri  de seamus en eurovision super living	es
Jueves con J de mierda	Jueves con j	es
No creo que haya en el mundo alguien que me d√© m√°s asco y sea m√°s subnormal que Dani Rovira.	No soporto a Dani Rovira	es
Mire la saga de 50 sombras de Grey...casi todo eran.lectoras...les va el.morbillo no lo.nieguen	Miren la saga de 50 sombras de Grey.. casi todo eran lectoras... le encanta	es
This. Que puto asco de respuestas, sois repulsivos	This. Que mala respuesta	es
ya me han venido los 4 fachas de turno a tocarme los cojones	Ya me han venido las 4 de turno a molestarme	es
Mano, puto subnormal, dos veces te lo he tenio que repetir	Mano, dos veces te lo he tenio que repetir	es
Te lo llama hasta tu cu√±ado. Pero no sufras, ¬øqui√©n no tiene un mongolo en la familia?	te lo llama hasta tu cu√±ado. pero tranquilo, ¬øquien no tiene a una persona de capacidades diferentes en la familia?	es
Celebrando mas feliz una victoria del Barsa que una del Sevilla... Este subnormal no me representa como sevillista	Celebrando mas feliz una victoria del Barsa que una del Sevilla... No me representa como sevillista	es
Si ese magrebi hubiera estado en su pais, podriamos haber evitado ese hecho.	Si ese individuo de origen magreb√≠ hubiera estado en su pa√≠s, podr√≠amos haber evitado ese incidente.	es
Y como siempre los nacotes sin educaci√≥n diciendo groser√≠as, son los que est√°n en contra de este gran gobierno respetable.	Y, como siempre, las personas sin educaci√≥n dicen groser√≠as, son las que se oponen a este gran gobierno respetable.	es
Qu√© bien. Hay que ver con los ingenieros, doctores y dem√°s cracks que nos llegan...	Es impresionante ver a los ingenieros, doctores y otros expertos que llegan a nuestro pa√≠s.	es
La historia reconocer√° que fue el m√°s pelele , inepto e hijo de puta presidente de la historia .	La historia reconocer√° que fue el m√°s inepto e hijo  presidente de la historia	es
JAJAJAJAJJA Hostia puta que bueno JAJAJAJAJAJA	JAJAJAJAJJA wow que bueno JAJAJAJAJAJA	es
Sin duda y durante los pr√≥ximos meses con un email solucionan si no les llega	Sin duda, en los pr√≥ximos meses se solucionar√° con un correo electr√≥nico, si es que no reciben la informaci√≥n.	es
Lee mongolo, lee. Deja de dar pena	Lee hombre, lee. Deja de dar pena.	es
Qui√©n te querr√≠a besar a ti, mongolo.	Quien te querria besar a ti	es
Y el mam√≥n se vuelve a Par√≠s con dos palmos de narices	Y se vuelve a Par√≠s con dos palmos de narice	es
Ese buen hombre por lo menos pagar√° 7 u 8 pensiones. Es el m√°s valiente sin duda.	Ese hombre generoso seguramente est√© contribuyendo con al menos 7 u 8 pensiones. Es admirable su valent√≠a.	es
6 a√±os ha tardado en mostrarse el tarado mental m√°s grande, bravo üëè	6 a√±os ha tardado en mostrarse el personaje m√°s grande, bravo üëè	es
Me confirman por aqu√≠ que mi padre es subnormal.	Me confirman por aqu√≠ que mi padre est√° loco.	es
menudos fachas xDDDDDDDDD HIJOS DE PUTA	menudos fachas xDDDDDDDDD	es
Pues un h√©roe el que se bebi√≥ el zumo, de no haberlo hecho este estar√≠a vendiendo corbatas por los bares	Realmente fue un acto her√≥ico de quien se bebi√≥ el zumo. De no haberlo hecho, es probable que esa persona estuviera vendiendo corbatas en los bares	es
Aprende el significado de mayor√≠a parlamentaria subnormal	Aprende el significado de mayor√≠a parlamentaria	es
Est√° claro que el lobby proxeneta est√° bien organizado üëøüëø	Est√° claro que su lobby est√° bien organizado üëø  üëø	es
ESTA NOCHE, MANDA MI POLLA (un primo suyo)	Esta noche manda mi primo	es
ha habido 6, no 5, 6.... Guti Guti Maricoooon, Maricoooon Maricoooooooon	ha habido 6, no 5, 6.... !!!!!!!!!	es
La √∫ltima mamarrachada de EA es tremenda.	La √∫ltima payasada de EA es tremenda.	es
Antes me como un whopper que decir algo bueno del subnormal ese	Antes me como un Whopper porque decir algo de √©l	es
"Y lo dice un mongolo que se est√° forrando en la ""democr√°tica"" Catar, para el parn√© no tiene problemas democr√°ticos"	"Y lo dice uno que se est√° forrando en la ""democr√°tica"" Catar, para el parn√© no tiene problemas democr√°ticos"	es
Origen patol√≥gico , delincuencial , usurpante , ilegal resultado delicuncial usurpante y patol√≥gico	Origen patol√≥gico, ilegal resultado delicuncial usurpante y patol√≥gico	es
El chepas acaba de solucionar el problema de la inmigraci√≥n, ahora vendr√°n los de Vox a tocar los huevos...	El chepas acaba de solucionar el problema de la inmigraci√≥n, ahora vendr√°n los de Vox a tocar molestar...	es
S√≠, para que lo suelten a la media hora. Alguien que hace eso s√≥lo aprende de una manera.	S√≠, pero suelen liberarlo despu√©s de media hora. Alguien que recurre a eso solo aprende de una manera.	es
Tanto que hablan de Pinochet y los gringos y estos hijueputas son iguales o peores.	Tanto que hablan de Pinochet y los gringos y estos son iguales o peores.	es
Este es el maric√≥n de Aida?	Este es el de Aida?	es
Son los mejores. Paguita, alquiler y seguridad social ya. Rasistas	Son los mejores. Paguita, alquiler y seguridad social ya.	es
Cogiendo el testigo de su colega,el mongolo Roncero. Vaya paga que tienes,carajaula	Cogiendo el testigo de su colegaRoncero. Vaya paga que tienes	es
No se puede tener peor gusto dise√±ando camisetas pa una pe√±a  Que verguenza maricon	No se puede tener peor gusto dise√±ando camisetas pa una pe√±a  Que verg√ºenza.	es
Los canis del 2000 y posteriores son a√∫n m√°s gilipollas que los anteriores.	Los canis del 2000 y posteriores son a√∫n m√°s malos que los anteriores.	es
Otro d√≠a de mierda, en √©ste mes de mierda, de √©ste a√±o de mierda	Otro d√≠a malo, en √©ste mes malo, de √©ste a√±o malo	es
da cobertura a terroristas de #Venezuela La deriva fascista del  y sus medios es muy preocupante. #ConElFranquismoHemosTopado	la cobertura terrorista de # Venezuela de la deriva del pa√≠s y sus medios de comunicaci√≥n es una gran preocupaci√≥n. #Conelfranquismo	es
Un caracol inv√°lido es m√°s r√°pido que esta internet de mierda	Un caracol inv√°lido es m√°s r√°pido que esta internet	es
"Veo el tweet y digo ""mira un subnormal"" pero veo los reply y no, son unos cuantos m√°s."	"Veo el tweet y digo ""mira un personaje"" pero veo los reply y no, son unos cuantos m√°s."	es
"Y a m√≠ qu√© me importa lo que t√∫ ""notes"", facha?"	"Y a m√≠ qu√© me importa lo que t√∫ ""notes""?"	es
¬øVan a seguir con el mismo tema de los comediantes mediocres?	¬øVan a seguir con el mismo tema de los comediantes?	es
C√≥mo me alegro de la remontada por todos los madridistas insoportables y por el subnormal miarma de Emery!!	C√≥mo me alegro de la remontada por todos los madridistas y por el miarma de Emery!!	es
En la puta casa del chaquetero de Aliaga los tendr√≠an que poner	En la casa de Aliaga los tendr√≠an que poner	es
La esposa no solo hacia lofts sin licencia sino que ni siquiera ten√≠a la carrera de arquitectura. Detalles sin importancia.	La esposa no solo constru√≠a lofts sin licencia, sino que ni siquiera ten√≠a formaci√≥n en arquitectura. Son detalles sin importancia.	es
Si controlan mucho porque son dictadores, si no controlan son pelotudos.	Si controlan mucho porque son dictadores, si no controlan est√°n haciendo cosas mal	es
Y los otros haci√©ndose los traumados cuando no dudar√≠an en hacer eso mismo	Y los dem√°s actuando como si estuvieran afectados, cuando en realidad no dudar√≠an en hacer lo mismo	es
Segurola es un subnormal desde el minuto 1.	Segurola siempre ha sido as√≠ desde el minuto 1	es
Menudos gilipollas. Como no, ten√≠an que ser los guardaespaldas de la nazi de Le Pen...	Por supuesto, ten√≠an que ser los guardaespaldas de Le Pen...	es
Mejor obedecer a Soros que ser como VOX , el lacayo de Vladimir Putin 	Es preferible seguir las indicaciones de Soros que adoptar posturas similares a VOX, que es considerado un aliado de Vladimir Putin.	es
Por cierto, donde anda metido el gusano comunista ese?	¬øAd√≥nde fue ese Comunista?	es
Lo que Cuba hace, como siempre, es propaganda mentirosa para que descerebrados como Nu√±ez repitan como loros.	Lo que Cuba est√° haciendo, como siempre, es propaganda para que gente como N√∫√±ez repita.	es
Quien putas est√° RT esa mierda ?	Quien est√° RT esto?	es
"el t√©rmino correcto es ""seres humanos de color crema"""	"El t√©rmino correcto es ""personas de tono crema""."	es
a ver eso se elige, no es natural... Vas a arder en el infierno por sodomita.	eso se elige, no es natural	es
Hostia, como la quimioterapia, nos hace da√±o, pero si aguantamos lo suficiente, podemos vencer al c√°ncer.	Como la quimioterapia, nos hace da√±o, pero si aguantamos lo suficiente, podemos vencer al c√°ncer.	es
Que manera de perder la cabeza por un zumo.	Resultado: Perder la calma por un zumo es exagerado.	es
Putos rojos de mierda subvencionando con 40 millones algo tan innecesario como la cultura #BoicotAlosGoya	Rojos est√°n subvencionando con 40 millones algo tan innecesario como la cultura #BoicotAlosGoya	es
Lleg√≥ la racista maleducada, odias mi castellano al igual que a Espa√±a y los espa√±oles, supremacista arruinada y avergonzada	Llego la persona sin respeto hacia los demas, no le gusta mi forma de hablar igual que Espa√±a y los espa√±oles, que verg√ºenza	es
Algunos pierden la cabeza por llegar a Paguitalandia.	algunos se desgastan por llegar a Paguitalandia	es
Pero siguen estando ah√≠ y recibiendo subvenciones de la ilesia y del estado FASCISTA	Siguen estando ah√≠ y recibiendo subvenci√≥nes	es
Pues puede trabajar de carnicero para pagar pensiones	Entonces podr√≠a trabajar como carnicero para cubrir las pensiones.	es
Tranquil√≠zate t√∫, ya que se supone que eres analista deportivo, no comediante o payaso, aunque a veces parezca lo contrario.	T√≥melo con calma, ya que debe ser un analista deportivo, no un comediante, aunque a veces puede parecer lo contrario.	es
No, lo que parece de ese siglo es su puta bazofia de programa.	No, lo que parece de ese siglo es su asqueroso programa	es
Pobre tarado que no sabes lo que dices .... pobre tarado	no sabes lo que dices	es
Soy bioqu√≠mico y estoy trabajando para el Gobierno de Navarra... √°nimo, puto subnormal.	Soy bioqu√≠mico y estoy trabajando para el Gobierno de Navarra...	es
Hoy prefieren el arbitraje manual. La mano negra del puto alem√°n ladr√≥n.	Hoy prefieren el arbitraje manual	es
"A saber cuantos imb√©ciles recibieron dinero y sin hacer una mala pel√≠cula siquiera."""	"A saber cuantos recibieron dinero y sin hacer una mala pel√≠cula siquiera."""	es
El hom√≥fobo #obispo de #Cordoba recomienda rezar m√°s en vacaciones [y follar menos, claro].  v√≠a	El  #obispo de #Cordoba recomienda rezar m√°s en vacaciones .  v√≠a	es
Yo voy a hacer #BoikotalosGoyas viendo la gala üòÇüòÇ Que pa√≠s de fachas!!!	Yo voy a hacer #BoikotalosGoyas viendo la gala üòÇüòÇ Que pa√≠s!!!	es
vete a un cajero mamon	vete a un cajero	es
Que bronca cuando est√°s jugando al FIFA y ponen pausa para responder los msj, que trolo man	Qu√© frustraci√≥n cuando est√°s jugando al FIFA y ponen pausa para responder los msj	es
¬øa que sigues los pasos del poeta maricon?	¬øa que sigues los pasos del poeta?	es
ese t√≠o no es un delicuente, en su cultura mayormente est√° admitido, lo que es, es un hijo de puta	Ese tio no ev un delincuente, es su cultura mayormente esta admitido	es
Lo que est√° claro es que ha llegado un ladr√≥n menos.	Lo que esta claro es que hay menos ladrones	es
Totalmente de acuerdo con la diputada, a esos c√°fres asquerosos que no los vayan a dejar devolver a Bogot√°.	Estoy totalmente de acuerdo con el diputado que no les permitir√° regresar a Bogot√°.	es
Pero el calentamiento global son COSAS DE HIPPIES Y PERROFLAUTAS	Pero el calentamiento global son COSAS DE HIPPIES	es
ESPA√ëA CORRUPPCI√ìN Derecha PP fascista franquista gobernando con 30% en Espa√±a no entiende porqu√© Catalu√±a quiere Independencia y Rep√∫blica.	ESPA√ëA un partido de derecha CORRUPTO que gobierna con el 30% en Espa√±a no entiende por qu√© Catalu√±a quiere la Independencia y la Rep√∫blica.	es
no podia esperar a llegar a tierra para ponerse manos a la. obra	No pod√≠a esperar a llegar a tierra para comenzar a trabajar.	es
VIEJA PAYASA....................................... APARTA TU MIERDA DE MI MIERDA..................................... NO ME SEAS LOCA	No acerques tus cosas a mis cosas, por favor	es
Los mejores, los m√°s valientes y preparados.	Los mejores, los m√°s valientes y preparados	es
No han dicho ya que vienen los mejores y los mas preparados?	S√≠, se ha mencionado que vienen los mejores y los m√°s preparados.	es
Tantos les cuesta entender simios de mierda	Tantos les cuesta entender	es
,, pin pon , todos los rojos delincuentes en sus ejercicio  ..	pin pon , todos los rojos en sus ejercicio	es
Me cuesta creer que haya alguien igual de subnormal que Dalas.	Me cuesta creer que haya alguien igual que Dalas.	es
y snk ultima temp pronto   pd rachel puta zorra la traicion no se perdona	ps rachel la traici√≥n no se perdona	es
"No hay que indicar ni√±a ""blanca espa√±ola"" ni nada? "	No es necesario especificar la nacionalidad o etnia al referirse a una ni√±a.	es
SALVEMOS A ESE ANIMAL DE LAS GARRAS ASESINAS Y FASCISTAS YA	SALVEMOS A ESE ANIMAL DE LAS GARRAS  YA	es
Hacete cargo forro de mierda	Asumir la responsabilidad	es
Eso no lo sabemos, puede que vinieran de peque√±os. Si es asi, expulsi√≥n.	No podemos estar seguros, podr√≠an haber venido de peque√±os. Si es el caso, considerar la expulsi√≥n.	es
No he le√≠do a una sola mujer quejarse de twitt solo a los de siempre....los machirulos fachas ...que asquito	No he le√≠do a una sola mujer quejarse de twitt	es
T√∫ debes de ser un facha costalero del PPodrido.	Debes ser un comerciante costero.	es
"ya sabes q la Mal_llamada ""PERRA"" (=FIEL)  de la TOP FURCIA de Eugenia SILVA estuvo jugando al APOCALIPSIS..con l ex_marido.."	ya sabes que la TOP FURCIA de Eugenia SILVA estuvo jugando al APOCALIPSIS..con l ex_marido..	es
Expulsado #Guillermo Un mamarracho Herrera üí©	Expulsado #Guillermo	es
Ah√≠ ah√≠, protegiendo a tus ni√±os. A los mejores. ¬øA cuantos tienes metidos en casa?	Ah√≠ est√°s, protegiendo a tus hijos. A los m√°s destacados. ¬øCu√°ntos tienes en casa?	es
Es su cultura y hay que respetarla. Un abrazo desde Ronda, M√°laga.	Es importante respetar su cultura. Un saludo desde Ronda, M√°laga.	es
son sus costumbres y hay que respetarlas..	Son tradiciones que merecen ser respetados	es
el Partido Socialista de Andaluc√≠a son una banda de delincuentes y chorizos	el Partido Socialista de Andaluc√≠a no son honrados	es
Ahora un nazi en RTVE #lahoraespinosadelosmonteros	Ahora este hombre en RTVE #lahoraespinosadelosmonteros	es
te has equivocado de captura subnormal	te has equivocado de captura	es
Supongo que el subnormal de  estar√° llorando porque Benzemierda no ha sido titular y Cristiano ha marcado.	Supongo que √©l estar√° llorando porque be Benzema no ha sido titular y Cristiano ha marcado	es
Qu√© mierda esa zozobra previa a los recortes de personal.	Qu√© zozobra previa a los recortes de personal.	es
Tu lo que eres es subnormal, punto.	Lo que eres no est√° bien y punto.	es
Fuentes del gobierno me comentan que hay que aumentar el altavoz para llamar a que vengan mas a intentarlo	Fuentes del gobierno indican que se debe aumentar el volumen para animar a m√°s personas a intentarlo.	es
Desde que los nazis falsificaron billetes en los campos,este es el peor ataque a la economia de un pais	Desde qu√© los nacionalsocialistas falsificaron billets en los campos, este es el peor ataque a la econom√≠a de un pais	es
Dios mi madre es subnormal en serio	Dios mi madre est√° mal en serio.	es
jaja eso es mejor que ser maricon o comunista	jaja eso es mejor que ser comunista	es
Que analog√≠a rebuscada y de mierda	Qu√© analog√≠a confusa	es
tienen cojones pero huyen para que otros les REGALEN LA VIDA, un poco contradictorio no?	Resultado: Tienen valent√≠a, pero buscan que otros les brinden la vida. ¬øNo es un tanto contradictorio?	es
Jajajajaja turco, subnormal, cu√±ado e espa√±ol madrem√≠a.... PLENOOOO	Jajajajaja turco, cu√±ado e espa√±ol madrem√≠a.... PLENOOOO	es
C√≥mo estar√° el pa√≠s para que ni los moros quieran estar	como estar√° el pais para que no quieran estar	es
S√≥lo me hacen encabronar, no debemos nada a Centroam√©rica ni los invasores para regalarles dinero.	S√≥lo me hacen enojar, no debemos nada a Centroam√©rica ni los invasores para regalarles dinero.	es
... ‚Äî putos rojos de mierda macho	estoy harto de los comunistas	es
Con el Zumo no se juega.	No se juega con el zumo.	es
Conclusi√≥n: pura mierda de paranormal....	Conclusi√≥n: pura de paranormal.	es
Por encima de la libertad de expresi√≥n est√° la libertad de callarse para no decir gilipolleces sin sentido	Por encima de la libertad de expresi√≥n est√° la libertad de permanecer en silencio para no decir cosas sin sentido	es
-Una directiva fracasa deportivamente -Unos monguers los votan para que sigan mandando -Los monguers se sorprenden d q fracasen #estapasando	Una directiva desilusiona deportivamente, unos monguers los votan para que sigan mandando, los monguers se sorprenden de que no sea un √©xito #estapasando	es
Pues s√∫bete tu a repararlo, maric√≥n	Pues s√∫bete tu a repararlo	es
Nunca sean as√≠ de mierdas.	Nunca sean as√≠  de malos	es
Seguro que era de pera-pi√±a. Es el √∫nico por el que yo matar√≠a.	Es posible que fuera de pera-pi√±a. Es el √∫nico por el que har√≠a algo as√≠.	es
Con Mokus y Fajardo, hay estos pol√≠ticos de mierda	Con Mockus y Fajardo hay estos pol√≠ticos	es
- Porque se que es la √∫nica forma que me visiten todos los fines de semana, borrachos malparidos	- Porque se que es la √∫nica forma que me visiten todos los fines de semana.	es
eso que llamas pol√≠tico del  no es un pol√≠tico es un ¬®miserable profesional¬®..	Lo que usted llama pol√≠tico no es un pol√≠tico, es un profesional‚Äù.	es
"A esosmoros hay que echarlos pero ya.O los politicos hacen algo o la gente tendra que ""actuar"""	"hay que echarlos pero ya.O los politicos hacen algo o la gente tendra que ""actuar"	es
Quien putas es Juan Sebasti√°n?	Vamos, ¬øqui√©n es Juan Sebasti√°n?	es
¬°Ese es mi Trump! üá∫üá∏Que vean la galamierda los giligoyas y rojeras de los veinte duros ¬°A mamarla!	¬°Este es mi Trump! üá∫üá∏Que los Giligoi y los pelirrojos del s√≥lido veinte vean este horror.	es
Lo que est√° claro es que t√∫ sigues siendo un operador pol√≠tico totalmente parcializado. Asco	Lo que est√° claro es que t√∫ sigues siendo un operador pol√≠tico totalmente parcializado.	es
Este pa√≠s se va a la mierda	nada puede salvar a este pa√≠s	es
Conclusi√≥n: Er Benni era un cabr√≥n facha que ayud√≥ a Trum	Conclusi√≥n: Er Benny fue un tipo rudo que ayud√≥ a Trump.	es
Aqu√≠ Piatti que no met√≠a un puto gol y en el Espa√±ol, lleva ya unos cuantos, mam√≥n. ‚òπÔ∏è	Aqu√≠ Piatti que no met√≠a un gol y en el Espa√±ol, lleva ya unos cuantos	es
En ESPA√ëA tenemos un Gobierno PSOE-UP, asi que simplemente estamos DISFRUTANDO LO VOTADO.	En Espa√±a, contamos con un Gobierno PSOE-UP, as√≠ que simplemente estamos experimentando las consecuencias de lo votado.	es
Supongo que Perro le dar√° asilo en la Moncloa 	Supongo que el presidente le dara asilo en la Moncloa	es
La jueza archiva la paliza de los trozos de mierda fascistas a Lagarder, porque la  no entreg√≥ la denuncia	La jueza archiva el problema de los fascistas a Lagarder porque no  entreg√≥ la denuncia	es
"Han quedado los √∫ltimos   ""Gran mayor√≠a""  Adem√°s de facha, tonto."	"Han quedado los √∫ltimos   ""Gran mayor√≠a"""	es
Me acojona ver a la derecha rancia pidiendo #BoicotALosGoya M√°s incultura seguir√° formando fascistas como ellos... ‚ûïCine ‚ûñToros #Espa√±ist√°n	Me asusta ver a la derecha pidiendo #BoicotALosGoya M√°s incultura seguir√° formando gente de derechas como ellos... ‚ûïCine ‚ûñToros #Espa√±ist√°n	es
Cortocircuito buenrrollista, pobres inmigrantes vs chica atacada sexualmente.	Es un conflicto entre el enfoque positivo y la compasi√≥n por los inmigrantes, frente a la preocupaci√≥n por una chica atacada sexualmente.	es
Habla en espa√±ol catal√°n de mierda.	Habla espa√±ol catal√°n	es
√Årbitro de mierda, Conmebol de mierda.	Ni buen √°rbitro, ni buena Conmebol.	es
Trump provocando como un macarra de pacotilla   v√≠a	Trump provocando	es
Gran puta estos chinos de mierda vinieron a arruinar mi a√±o üò≠	Estos chinos vinieron a arruinar mi a√±o	es
Basta ya hijos de las mil putas. Est√°is agotando a la Afici√≥n, lo √∫nico digno que queda en el club.	Basta ya. Est√°is agotando a la Afici√≥n, lo √∫nico digno que queda en el club.	es
Estas elecciones les van a venir de perlas a los fachas de VOX.	Estas elecciones les van a venir de perlas a los  de VOX.	es
Con periodistas de mierda, con empleados de mierda.	Con malos periodistas, con malos empleados	es
Creo que deber√≠an explotar este pa√≠s de mierda	Creo que deber√≠an hacer algo con este pa√≠s.	es
Si fuese verdad se lo estar√≠a pagando el gobierno y les dar√≠an una paga para que no tengan problemas econ√≥micos.	Si eso fuera cierto, el gobierno les proporcionar√≠a ayuda econ√≥mica para evitar problemas financieros.	es
Habla espa√±ol, catal√°n de mierda üòã	Habla espa√±ol	es
Lo mejor, es que ya lo tenemos aqu√≠ y tenemos que mantenerlo en la c√°rcel, gracias	Lo positivo es que ya lo tenemos aqu√≠ y debemos asegurarnos de mantenerlo en la c√°rcel, muchas gracias	es
Costumbres tercermundistas que disfrutamos ya en Europa gracias a nuestros pol√≠ticos progres, disfruten lo votado.	Costumbre de pa√≠ses en desarrollo que ya disfrutamos en Europa, gracias a los pol√≠ticos simpatizantes, disfruten el logro	es
La democracia espa√±ola y la interpretaci√≥n libre de sus leyes en manos de fascistas. 6D, nada que celebrar.	La democracia espa√±ola y la libre interpretaci√≥n de sus leyes en manos de dictadores. 6D, nada que celebrar.	es
Una paguita para ese hombre, que se ve con ganas de integrarse y aceptar nuestras reglas/costumbres.	Ser√≠a apropiado proporcionar alguna ayuda econ√≥mica a ese hombre, parece estar dispuesto a integrarse y aceptar nuestras reglas y costumbres.	es
pues mucho  no entiendo pq llamarlo asi cuando la palabra no es ofensiva  putos progres	Pues mucho no entiendo pq llamarlo asi cuando la palabra no es ofensiva	es
Lagarder ya era un puto subnormal, solo que hoy quiere que quede patente.	Lagarder ya era una mala persona, solo que hoy quiere que quede patente.	es
Porque usted es un hombre de bien y con valores. Esos otros son alima√±as y 0	Porque usted es un hombre de bien y con valores. Esos otros no lo son	es
ya esta el subnormal de luis enrique jodiendome apuestas sin poner a suarez	ya esta luis enrique arruinandome apuestas sin poner a suarez	es
cuidado con estos conspiradores de mierda	Cuidado con estas personas	es
Nose que esperan para cerrar toda esa mierda	No s√© que esperan para cerrar eso	es
solo 4? maldito hijo de puta fascista	solo son 4?	es
Por que chingado los de Facebook tuvieron que hacer otra app para poder contestar mensajes üò°	Por que los de Facebook tuvieron que hacer otra app para poder contestar mensajes	es
#CeseDefinitivoCPCCS estos miserables su salida del CPCCS va hacer mas r√°pido q su puta nombramiento,	#CeseDefinitivoCPCCS  su salida del CPCCS va hacer mas r√°pido que su nombramiento,	es
Te gustan los ni√±os,fascista de mierda?	Te gustan los ni√±os?	es
Pero que putas, maldita tensi√≥n rara entre Jaime y Brandon #GameofThrones #JaimeLannister	Pero qu√© es, extra√±a tensi√≥n entre Jaime y Brandon.  #Game of Thrones  #JaimeLannister	es
Deber√≠a darte verg√ºenza ofender las creencias de otras persona, intolerante fascista.	Deber√≠a darte verg√ºenza ofender las creencias de otras persona.	es
lo personal es pol√≠tico pero no por ello tienes ke ir a una manifa ke convocan sindicatos de mierda	Lo personal es pol√≠tico pero eso no significa que haya que ir a una manifestaci√≥n que convoque a sindicatos.	es
As√≠ act√∫a la propaganda de la izquierda, como cualquier rancia dictadura	As√≠ act√∫a la propaganda de la izquierda, como cualquier dictadura	es
El tonto de FC. ¬øCon el PP no se pod√≠a abortar?	La persona de FC. ¬øCon el PP no se pod√≠a abortar?	es
Este va para casa de que politicucho? ya esta adjudicado, o se lo rifan?	¬øEsto va para la casa de qu√© pol√≠tico?	es
Sigue existiendo mucha basura en Espa√±a que limpiar y no solo en lo politico.	Sigue existiendo mucha cosas en Espa√±a que limpiar y no solo en lo politico.	es
Ya dec√≠a yo que ve√≠a menos moros	Ya me hab√≠a dado cuenta que ve√≠a menos personas de origen magreb√≠	es
Responde carajo ganster  de mierda.	Responde ahora	es
Y deportar a la escoria es parte de las leyes. Si para ti eso es justicia medieval haztelo mirar.	Y deportar a los ilegales es parte de las leyes. Si para ti eso es justicia medieval revisalo.	es
Me rio de ti jajajajajajjaja fascista a la cueva	Me rio de ti jajajajajajjaja	es
Los de ahora son un infierno pol√≠tico y social, ocasionados por pol√≠ticos fan√°ticos	Los de ahora son un infierno pol√≠tico y social, ocasionados por pol√≠ticos	es
Hay un puto subnormal pitando en mi calle todo el puto rato	Hay alguien silbando en mi calle todo el tiempo.	es
a la mierda directamente, OKUPAS en el gobierno.	OKUPAS en el gobierno.	es
fijate, todo tiene su lado bueno, hasta el puto coronabicho	F√≠jate, todo tiene su lado bueno.	es
¬øA qu√© puta perra hora suben el link de #HTGAWM?	¬øA qu√© hora cargan el enlace a #HTGAWM?	es
"Gobierno de mierda"""	Gobierno ineficiente	es
Que traigan otro cargamento, necesitamos m√°s pagapensiones son una inversi√≥n de futuro.	Que traigan otro cargamento, necesitamos m√°s contribuyentes para asegurar las pensiones; son una inversi√≥n de futuro.	es
La derechona sale a dar una vuelta por Barcelona.  v√≠a	La derecha sale a dar una vuelta por Barcelona. Via	es
Ahora tampoco respetar√©is la democracia fascistas de mierda???	Ahora tampoco respetar√©is la democracia????	es
lo que es curioso es que todos los imbeciles que llevan bandera podemita demuestra ser imbecil,con nota	Lo qu√© es curioso es que todos los qu√© lleven bandera podemita demuestra cadecer de razonamiento, con nota	es
üö®üö® Los okupas causan graves disturbios en Santiago y el alcalde 'podemita' les respalda ‚û°Ô∏è  SON GENTUZA	Los okupas causan graves disturbios en santiago y el alcalde podemita les respalda	es
Marhuenda, ese gilipollas que dice que es catal√°n solo cuando pretende da√±ar a todos los catalanes, llama...	Maruenda, este que dice ser Catal√°n solo cuando pretende hacer da√±o a todos los catalanes, llama...	es
Ll√©venlos a prisi√≥n, y una vez paguen la condena enviarlos a su pa√≠s por deportaci√≥n.	Ll√©venlos a prisi√≥n y, despu√©s de cumplir la condena, procedan con su deportaci√≥n a su pa√≠s.	es
Pues a mi me recuerda tus diversas lesiones graves y me descojono, subnormal. Acabado.	Bueno, me recuerda tus diversas lesiones graves y me enfado.	es
Tiene que ser fake, no me jodas. Jam√°s volver√≠an a sus pa√≠ses.	Tiene que ser fake, no me hagas bromas. Jam√°s volver√≠an a sus pa√≠ses.	es
Puta prensa deportiva saliendo en defensa de un puto ultraderechista	Prensa deportiva saliendo en defensa de un ultraderechista	es
a ti no catal√°n cabron jajaja! Esta champions es vuestra y del bayer xd	a ti no catal√°n jajaja! Esta champions es vuestra y del bayer xd	es
El dia que morais todos los fachas podre palmarla tranquilo ...	El d√≠a en que desaparezcan todos los extremistas, podr√© vivir en paz...	es
"#Lista Allanamientos, persecuci√≥n y exilio: la aberraci√≥n de #ANC contra diputados  `"""	"# Lista de invasiones, persecuciones y expulsiones: # ANC contra diputados `"""	es
Dale la vuelta a la camiseta y tienes el 6 del 6-1 de la REMONTADA MAM√ìN!!!	Dale la vuelta a la camiseta y tienes el 6 del 6-1 de la REMONTADA!!!	es
Luego se queja Neymar... valiente subnormal.	Entonces Neymar se queja... valiente y extra√±o.	es
gummy cuando te pones subnormal eres un tocacojones	Gummy, cuando te comportas de manera inapropiada, te vuelves una molestia.	es
Venga silenciame ya ver√°s t√∫ cu√°nto me preocupo SUBNORMAL	Vengan a silenciarme ya ver√°n cu√°nto me preocupo	es
Cuando alguien intenta manipular de manera tan burda lo que provoca es asco. Miratelo.	Cuando alguien intenta manipular de manera tan vil lo que provoca es pena.	es
deja de tirarte abajo hija d re mil puta	deja de tirarte abajo	es
Empiezo a sospechar que los traperos quieren competir con los youtubers para ver que grupo es m√°s subnormal.	Empiezo a sospechar que los traperos quieren competir con los youtubers para ver que grupo es el peor.	es
Los mierdas de ABC haci√©ndole campa√±a al Fracking.	ABC promociona el fracking.	es
Estos fascistas de la oposici√≥n venezolana, y sus achichincles en Espa√±a, tienen la suerte de que no somos como ellos.	Estas personas de la oposici√≥n venezolana y sus c√≥mplices en Espa√±a tienen la suerte de que no somos como ellos.	es
imagina y todo fue por entrar con una maleta en un museo. Putos nazis	imagina y todo fue por entrar con una maleta en un museo.	es
Este cabron est√° peor que los 1,200 que est√°n por llegar	Es peor que los 1.200 que a√∫n est√°n por venir	es
Otro espa√±olazo fascista coaccionando al pueblo catal√°n secesionista.	Otro espa√±olazo coaccionando al pueblo catal√°n secesionista.	es
Solo la fe, el dogmatismo y la estupidez te pueden hacer votar a un elemento como este #SanchezVeteATuCasa	Solo la fe, el dogmatismo y falta del sentido com√∫n te pueden hacer votar a un elemento como este #SanchezVeteATuCasa	es
Pero que pedazo de retrasada	Pero qu√© tipo de persona.	es
El gobierno de mierda, deber√≠a dejar de hablar hue√°s contra toda evidencia.	El gobierno, deber√≠a dejar de hablar hue√°s contra toda evidencia.	es
ahora ser liberal es de retrasado? pues eres un poco hipocrita y tonto amigo	Se considera ahora que ser liberal es poco com√∫n? Me parece que hay un contraste entre tus opiniones y acciones, amigo	es
Lo tratar√© con el trato maricon, penca, discriminatorio como trat√≥ a varios de mis compa√±eros üòí VIEJO CULIAO.	Lo tratar√©  como trat√≥ a varios de mis compa√±eros	es
Tu eres subnormal, no refinado, no confundas t√©rminos.	T√∫ no eres refinado no confundas t√©rminos	es
hijo de puta subnormal cabeza de polla gilipollas mental zoquete	hombre malo	es
Blocs y a otra cosa No le des publicidad al monguer	Blocs y a otra cosa No le des publicidad	es
#YoSoyAnonymousUE basta de absurda represi√≥n victimista por parte del Estado Fascista	#YoSoyAnonymousUE basta de absurda represi√≥n victimista por parte del Estado	es
En el fondo me alegro por el subnormal de Emery.	En el fondo me alegro por Emery.	es
En 2013 Dalas ya se sab√≠a que era retrasado, que cojones?!	En el 2013 salas ya se sab√≠a que era m√°s lento	es
Un Catalan a clasificado al Bar√ßa  Cabroooooonnn	Un Catalan a clasificado al Bar√ßa	es
jaja ok andate con la zorra esa chau olvidate de mi :)	Jaja ok andate con ella chau olvidate de mi :)	es
Para el podemitariado y los lobotomizados del noreste espa√±ol, Cristina Pardo tambi√©n es facha.	Para los de izquierdas del noreste espa√±ol, Cristina Pardo tambi√©n es de extrema derecha	es
En catal√°n se escribe Espanya. Para d√°rselas usted de ser periodista, no tieene usted puta idea de escribir.	En catal√°n se escribe Espanya. Para d√°rselas usted de ser periodista, no tieene usted  idea de escribir.	es
por desgracia a√∫n no entregan Goyas por el simple hecho de ser subnormal. Deber√≠an empezar	por desgracia a√∫n no entregan Goyas	es
los Salesianos de San Francisco de Sales, Los Marianistas y los fascistas vecinos del San Cirano nos ablandaron en exceso.	los Salesianos de San Francisco de Sales, Los Marianistas y los vecinos del San Cirano nos ablandaron en exceso.	es
Vaya, nunca pens√© oir decir eso a una mujer	Nunca esper√© escuchar eso de una mujer.	es
Los halagos y buenos modales siempre hacen bien, menos a los izquierdistas de la cultura del odio.	Los halagos y buenos modales siempre hacen bien, menos a los izquierdas de la cultura del odio.	es
Ser√° puerta abierta , in√∫tiles fascistas embusteros miserables,no?	Ser√° puerta abierta ,no?	es
unos vecinos del primero son m√°s rojos y perroflautas que la hostia, les he dejado 6 entradas en el buz√≥n	unos vecinos del primero son comunistas, les he dejado 6 entradas en el buz√≥n	es
y encima esqe eres mu puta	Y encima es que eres m√≠a	es
¬øY este subnormal qui√©n es?	Y este hombre extra√±o, ¬øqui√©n es?	es
Luego si empiezan a aparecer los cad√°veres de esta basura alguien se echara las manos a la cabeza.	Luego si empiezan a aparecer los cad√°veres alguien se echara las manos a la cabeza	es
A su vez que no es lo mismo ser cristiano que catolico , pero tu eres CATETA.	A su vez que no es lo mismo ser cristiano que catolico.	es
Es asombroso el nivel de estupidez-robotizaci√≥n del adoctrinamiento progre.	Resultado: Es sorprendente el nivel de robotizaci√≥n en el adoctrinamiento progresista.	es
al guadalquivir primooo! Sigue insultando por internet, que eres un gitano falso.	Al guadalquivir primo sigue haciendo comentarios ofensivos por internet	es
Pinche gobierno de mierda, no ayudan pero como estorban HDSPM.	gobierno, no ayudan pero como estorban HDSPM.	es
Disney se est√° riendo en vuestra puta cara	Disney se est√° riendo de ustedes	es
Daniel has muerto o algo no te veo twittear como un subnormal	Daniel has muerto o algo no te veo twittear	es
Y ahora me veo y parezco un Trump supporter. Putos nazis.	Y ahora me veo y sueno como un partidario de Trump.	es
Qu√© peste a cul√© esta pillando la afici√≥n madridista...	Qu√© peste esta pillando la afici√≥n madridista...	es
Son sus costumbres y hay que respetarlas	Cada grupo tiene sus propias tradiciones y es importante respetarlas	es
Hay gente d√°ndose cuenta de que Hamilton es imb√©cil en pleno 2020.	Hay personas que entienden que Hamilton no es el mejor a mediados de 2020.	es
Si los ladrones y golpistas de izquierda no le hubieran hecho tanto da√±o a Chile, probablemente todo ser√≠a mejor.	Si la izquierda no hubiera hecho tanto da√±o a Chile, probablemente las cosas habr√≠an sido mejores.	es
Menudo ba√±o te est√°n dando peque√±o dictador! üëèüëèüëèüëèüëèüëèüëè	Menudo ba√±o te est√°n dando	es
No busqu√©is m√°s, ya tenemos al tonto del hilo.	No busqueis mas, aqui esta quien faltaba	es
Que asco da la gente hom√≥foba, COMENTO. ‚Äî MUCHO ASCO	No soporta la gente hom√≥foba	es
Estaba tan bien durmiendo hasta q vino roco a despertarme, enano de mierdaüòí	Estaba tan bien durmiendo hasta q vino roco a despertarme üòí	es
Los Reyes Magos JAJAJAJAJAJAJAJAJAJAJAJAJA  Puto retrasado #TierradeNadie10	Los Reyes Magos JAJAJAJAJAJAJAJAJAJAJAJAJA  #TierradeNadie10	es
